█ █ █ █ █ █ █ █ █ █ █ █ █ █ █ █ █ █ █ █ 
█     █                               █ 
█ █   █ █ █   █   █   █ █ █ █ █   █ █ █ 
█         █   █   █           █       █ 
█ █ █ █   █ █ █   █   █ █ █   █ █ █ █ █ 
█ █   █           █       █   █   █   █ 
█ █   █ █ █   █ █ █   █ █ █   █   █   █ 
█             █       █               █ 
█ █   █ █ █   █   █   █ █ █ █ █   █ █ █ 
█     █       █   █   █       █       █ 
█ █   █ █ █   █ █ █ █ █ █ █   █   █ █ █ 
█     █                       █       █ 
█ █   █ █ █ █ █ █ █   █   █ █ █   █ █ █ 
█                 █   █       █       █ 
█ █ █ █   █   █ █ █   █ █ █   █ █ █ █ █ 
█ █       █   █       █               █ 
█ █ █ █   █ █ █ █ █   █ █ █ █ █ █ █   █ 
█         █       █           █       █ 
█ █   █ █ █   █   █   █ █ █   █ █ █   O 
█ █ █ █ █ █ █ █ █ █ █ █ █ █ █ █ █ █ █ █ 



